00000000000000000000000000000000000000000000000000000000000000000
00000000000000000000000000000000000000000000000000000000000000000
00000000000000000000000000000000000000000000000000000000000000000
00000000000000000000000000000000000000000000000000000000000000000
00000000000000000000000000000000000000000000000000000000000000000
00000000000000000000000000000000000000000000000000000000000000000
00000000000000000000000000000000000000000000000000000000000000000
00000000000000000000000000000000000000000000000000000000000000000
00000000000000000000000000000000000000000000000000000000000000000
00000000000000000000000000000000000000000000000000000000000000000
00000000000000000000000000000000000000000000000000000000000000000
00000000000000000000000000000000000000000000000000000000000000000
00000000000000000000000000000000000000000000000000000000000000000
00000000020000000000000002000000000000000000000000000000000000000
00000000060000000000000006000000000000000000000000000000000000000
00000000070000000000000007000000000000000000000000000000000000000
00000000080000000000000008000000000000000000000000000000000000000
00000000000000000000000000000000000000000000000000000000000000000
00000000000000000000000000000000000000000000000000000000000000000
00000000000000000000000000000000000000000000000000000000000000000
00000000000000000000000000000000000000000000004000000000000000000
00000000000000000000000000000000000000000000005000000000000000000
00000000000000000000000000000000000000000000222220000000000000000
00000000000000000000000000000000000000000000000000000000000000000
00000000000000000000000000000000000000000000000000000000000000000
00000000000000000000000000000000000000000000000000000000000000000
00000000000000000000000000000000000000000000000000000000000000000
00000000000000000000000000000000000000000000000000000000000000000
00000000000000000000000000000000000000000000000000000000000000000
00000000000000000000000000000000000000000000000000000000000000000
00000000000000000000000000000000000000000000000000000000000000000
00000000000000000000000000000000000000000000000000000000000000000
00000000000000000000000000000022200200000000000000000000000000000
02220000000000000000000000000000000000000000000000000000000000000
00000000000000000000000022200000000000000000000000000000000000000
00000000000000002220000000000000000000000000000000000000002220000
00000040000000000000000000000000000000000000000000000000000000000
00000050000000000000000000222000000000000000000000000000000000000
00000020000000000000000000000000004000002000000000000000222200000
00000000000004000000000000000000005000000000000000000022200000000
00000000000005000000000000000000022220000000000000000000000000000
00000000000002220000000000000002222220000000000000000000000004000
00000220000222222200002200000222222222220000000000000000000005000
33313333331333333333333311331333333333333333333333311331333333339
33313333331333333333333311331333333333333333333333311331333333333