000000000000000000000000000000000000000000000000000000000000000000000000000000000000000000000000000
000000000000000000000000000000000000000000000000000000000000000000000000000000000000000000000000000
000000000000000000000000000000000000000000000000000000000000000000000000000000000000000000000000000
000000000000000000000000000000000000000000000000000000000000000000000000000000000000000000000000000
000000000000000000000000000000000000000000000000000000000000000000000000000000000000000000000000000
000000000000000000000000000000000000000000000000000000000000000000000000000000000000000000000000000
000000000000000000000000000000000000000000000000000000000000000000000000000000000000000000000000000
000000000000000000000000000000000000000000000000000000000000000000000000000000000000000000000000000
000000000000000000000000000000000000000000000000000000000000000000000000000000000000000000000000000
000000000000000000000000000000000000000000000000000000000000000000000000000000000000000000000000000
000000000000000000000000000000000000000000000000000000000000000000000000000000000000000000000000000
000000000000000000000000000000000000000000000000000000000000000000000000000000000000000000000000000
000000000000000000000000000000000000000000000000000000000000000000000000000000000000000000000000000
000000000000000000000000000000000000000000000000000000000000000000000000000000000000000000000000000
0000000000000000000000000000000000000000000000000000000000000000000p0000000000000000000000000000000
000000000000000000000000000000000000000000000000000000000000002222222000000000000000000000000000000
000000000000000000000000000000000000000000000000000000000000000000000000000p0p000000000000000000000
000000000000000000000000000000000000000000000000004000002222000000000000002222222000000000000000000
000000000000000000000000000000000000000000000000005000000000000000000000000000000000000000000000000
000000000000000000000000222200000000000000002222222000000000000000000000000000000000000000000000000
000000000000000000000000000000222200000000000000000000000000000000000000000000000000000000000000000
0000000000000000000000000000000000000222000000000000000000000000p0000000000000000000000000000000000
000000000000000000000000000000000000000000000000000000004000002222000000000000000000000000000000000
000000000000000000000000000000000000000000000000000000005000000000000000000000000000000000000000000
000000000000000000000000000000000000000000002220022200222000000000000000000000000000000000000000000
000000000000000000000000000000000000000000000000000000000000000000000000000000000000000000000000000
0000000000000000pppp0000p00000000000000000000000000000000000000000000000400000000220000000000000000
000000000000222222222222222222000000000000000000000000000000000000000000500000000000000000000000000
00000000000000000000000000000000p000000000000000000000000000000000000222222200000000022200000000000
000000000000000000000000000002222222200000000000040000000000000002222222200022222200000000000000000
000000000000000000000000040000000000000000000000050000000000022222222000000000000000000000000000000
000000022220000000000000050000000000000000222222220000000000000000000000000000000004000000000000000
000000000000000000000002220000000000000000000000000000000000000000000000000000000005000000000000000
000000000000000000000000000000000000000000000000000000222000000000000000000000000002000000000000000
000000000000000000000000000000000000000000000000000000000000000000000000000000000000000000000000000
000000000000000000000222222000000000000022200000000000000000000400000000000000000000000000000000000
00000000000p000000000000000000000000000000000000000000000000000500000000000000002200000000000000000
000000000022222200000000000000000000000000000000000000000000000220000000000000000000000000000000000
000000000000000000000000000000002222200000000000000000000000000000000000000000000000000000000000000
000000000000000000000040000000000000000000000000000000000000000000000000000002222000000000000000000
000000000000000000000050000000000000000000000000000000000000000000000000000000000000000000000000000
000000000000000000000020000000000000000000000000000000000000000000000000000000000000000000000000000
0000000pp0000000000002220000000pp000000022220000000000000ppp00000000022200222000000000000000pp00000
331333333331133333333333333333333331133333333333313333333333333333333333113333333333333333333333339
331333333331133333333333333333333331133333333333313333333333333333333333113333333333333333333333333