00000000000000000000000000000000000000000000000000000000000000000000000000000000000000000000000000000000000000000000000
00000000000000000000000000000000000000000000000000000000000000000000000000000000000000000000000000000000000000000000000
00000000000000000000000000000000000000000000000000000000000000000000000000000000000000000000000000000000000000000000000
00000000000000000000000000000000000000000000000000000000000000000000000000000000000000000000000000000000000000000000000
00000000000000000000000000000000000000000000000000000000000000000000000000000000000000000000000000000000000000000000000
00000000000000000000000000000000000000000000000000000000000000000000000000000000000000000000000000000000000000000000000
00000000000000000000000000000000000000000000000000000000000000000000000000000000000000000000000000000000000000000000000
00000000000000000000000000000000000000000000000000000000000000000000000000000000000000000000000000000000000000000000000
00000000000000000000000000000000000000000000000000000000000000000000000000000000000000000000000000000000000000000000000
00000000000000000000000000000000000000000000000000000000000000000000000000000000000000000000000000000000000000000000000
00000000000000000000000000000000000000000000000000000000000000000000000000000000000000000000000000000000000000000000000
00000000000000000000000000000000000000000000000000000000000000000000000000000000000000000000000000000000000000000000000
00000000000000000000000000000000000000000000000000000000000000000000000000000000000000000000000000000000000000000000000
00000000000000000000000000000000000000000000000000000000000000000000000000000000000000000000000000000000000000000000000
00000000000000000000000000000000000000000000000000000000000000000000000000000000000000000000000000000000000000000000000
00000000000000000000000000000000000000000000000000000000000000000000000000000000000000000000000000000000000000000000000
00000000000000000000000000000000000000000000000000000000000000000000000000000000000000000000000000000000000000000000000
00000000000000000000000000000000000000000000000000000000000000000000000000000000000000000000000000000000000000000000000
00000000000000000000000000000000000000000000000000000000000000000000000000000000000000000000000000000000000000000000000
00000000000000000000000000000000000000000000000000000000000000000000000000000000000000000000000000000000000000000000000
00000000000000000000000000000000000000000000000000000000000000000000000000000000000000000000000000000000000000000000000
00000000000000000000000000000000000000000000000000000000000000000000000000000000000000000000000000000000000000000000000
00000000000000000000000000000000000000000000000000000000000000000000000000000000000000000000000000000000000000000000000
00000000000000000000000000000000000000000000000000000000000000000000000000000000000000000000000000000000000000000000000
00000000000000000000000000000000000000000000000000000000000000000000000000000000000000000000000000000000000000000000000
00000000000000000000000000000000000000000000000000000000000000000000000000000000000000000000000000000000000000000000000
00000000000000000000000000000000000000000000000000000000000000000000000000000000000000000000000000000000000000000000000
00000000000000000000000000000000000000000000000000000000000000000000000000000000000000000000000000000000000000000000000
00000000000000000000000000000000000000000000000000000000000000000000000000000000000000000000000000000000000000000000000
00000000000000000000000000000000000000000000000000000000004000000000000000000000000000000000000000000000000000000000000
0000000000000000000000000000000000000000000000000000000000500p000000000000000000000000000000000000000000000000000000000
00000000000000000000000000000000000000000000000000000000002222220000000000000000000000000004000000000000000000000000000
00000000000000000000000000040000000000000000000000000000000000000000000000000000022220000005000000000000000000000000000
0000000000000000000000000005000000000000000000000000000000000000000000000p000000000000000022000000000000000000000000000
00000000000000000000000000022222000000000000000000000000000000000000022222220000000000000000000000000000000000000000000
00000000000000000000000000000000000000000000000000000000000000000000000000000000000000000000000000000000000000000000000
00000000000000000000000000000000000000000000000pp0000000000000000000000000000000000000000000000000000000000000000000000
00000000000000000022222000000000000000000000222222000000000000000000000000000000000000000000000000000000000000000000000
00000000000000000000000000000000004000000000000000000000000000000000000000000000002220000000000000000000000000000000000
00000000000000000000000000000000005000000000000000000000000000000000000000000000000000000000000000000000000000000000229
0000000000022p220000000000000000022000000000000000000000000000000000000000000000000000000000000000pp0000000000000022222
00000000000000000000000000000000000000000000000000000000000000000000002220000000000000000000000000222200000000002222222
00000pp0000p000p00000000000000000000000000pp0000p00000p000000000000022222220000000000000000000000000000000000p222222222
33333331133333331313331333333111331333333333333333313131313131313333333333333311133333333333313333333333133331333333333
33333331133333331313331333333111331333333333333333313131313131313333333333333311133333333333313333333333133331333333333