000000000000000000000000000000000000000000000000000000000000000000000000000000000000000000000000000
000000000000000000000000000000000000000000000000000000000000000000000000000000000000000000000000000
000000000000000000000000000000000000000000000000000000000000000000000000000000000000000000000000000
000000000000000000000000000000000000000000000000000000000000000000000000000000000000000000000000000
000000000000000000000000000000000000000000000000000000000000000000000000000000000000000000000000000
000000000000000000000000000000000000000000000000000000000000000000000000000000000000000000000000000
000000000000000000000000000000000000000000000000000000000000000000000000000000000000000000000000000
000000000000000000000000000000000000000000000000000000000000000000000000000000000000000000000000000
000000000000000000000000000000000000000000000000000000000000000000000000000000000000000000000000000
000000000000000000000000000000000000000000000000000000000000000000000000000000000000000000000000000
000000000000000000000000000000000000000000000000000000000000000000000000000000000000000000000000000
000000000000000000000000000000000000000000000000000000000000000000000000000000000000000000000000000
000000000000000000000000000000000000000000000000000000000000000000000000000000000000000000000000000
000000000000000000000000000000000000000000000000000000000000000000000000000000000000000000000000000
000000000000000000000000000000000000000000000000000000000000000000000000000000000000000000000000000
000000000000000000000000000000000000000000000000000000000000000000000000000000000000000000000000000
000000000000000000000000000000000000000000000000000000000000000000000000000000000000000000000000000
000000000000000000000000000000000000000000000000000000000000000000000000000000000000000000000000000
000000000000000000000000000000000000000000000000000000000000000000000000000000000000000000000000000
000000000000000000000000000000000000000000000000000000000000000002222220000000000000000000000000000
00000000000000000000000000000000000000000000000000000000000022222000000p000000000000000000000000000
000000000000000000000000000000000000000000000000000000000000000000000002222220000000000000000000000
000000000000000000000000000000000000000000000000000000000000400000000000000000000000000000000000000
000000000000000000000002222200000000000000000000000000000000500000000000000000000000000000000000000
000000000000000022222220000000000000000000000022222202222222200000000000000002200000000000000000000
000000000222222200000000000000000000000000000022222202222222200000000000000000000000000000000000000
000000000000000000000000000000000000000002222222222202222222222220000000000000000000000000000000000
000000000000000000000000pp00000040000000022222222222p2222222222220000000000000000000000000000000000
000000000000000000000222222200005000000000000000000000000000000000000000000004000000000000000000000
000000000000000000000000000000022222222000000000000000000000000000000000000005000000000000000000000
00000000000000002222200000000000000000000000000000000000000000p000000000222222000000000000000000000
00000000000000000000000000000000040000000000000000000000p000002222222000000000000000000000000000000
000000000022222222000000000000ppp500000000000000000002222220000000000000000000000000000000000000000
000000000000000000000000000222222200000000000000000000000000000000000000000000002220000000000000000
000000000000000000000000000000000000000000000000000000000000000000000000000000000000000000000000000
000000000000000000000000000000000000022200000000000000000000000400000022222200000000000000000000000
000000000000000000000000000000000000000000000000000000000000000500000000000000000000000000000000000
00000000000000000000022000000000pp00000000000000000000000000022222200000000000000000000000000000000
000000000000000000000000000000222200000000000000000000000000000000000000000000002222000000000000000
000000000000000000000000000000000000000000000000002200000000000000000000000000000000000000000000000
000000000000022222200000000000000000000000000000222222000000000000000000000000000000000222200000000
000000000000000000000000400000000000000000002222222222222200000000000000000000000000000004000000000
000000000ppp0000000000005000000000000000022222222222222222222200000000000ppp00000000000005000ppp000
333333333333333333311111333333333333333333333333333333333333333311113333333333113333333333333333119
333333333333333333311111333333333333333333333333333333333333333311113333333333113333333333333333113