0000000000000000000000000000000000000000000000000000000000000000000000000000000000000000000000000000000000000000000000000000000000000000000000000000000000000000
0000000000000000000000000000000000000000000000000000000000000000000000000000000000000000000000000000000000000000000000000000000000000000000000000000000000000000
0000000000000000000000000000000000000000000000000000000000000000000000000000000000000000000000000000000000000000000000000000000000000000000000000000000000000000
0000000000000000000000000000000000000000000000000000000000000000000000000000000000000000000000000000000000000000000000000000000000000000000000000000000000000000
0000000000000000000000000000000000000000000000000000000000000000000000000000000000000000000000000000000000000000000000000000000000000000000000000000000000000000
0000000000000000000000000000000000000000000000000000000000000000000000000000000000000000000000000000000000000000000000000000000000000000000000000000000000000000
0000000000000000000000000000000000000000000000000000000000000000000000000000000000000000000000000000000000000000000000000000000000000000000000000000000000000000
0000000000000000000000000000000000000000000000000000000000000000000000000000000000000000000000000000000000000000000000000000000000000000000000000000000000000000
0000000000000000000000000000000000000000000000000000000000000000000000000000000000000000000000000000000000000000000000000000000000000000000000000000000000000000
0000000000000000000000000000000000000000000000000000000000000000000000000000000000000000000000000000000000000000000000000000000000000000000000000000000000000000
0000000000000000000000000000000000000000000000000000000000000000000000000000000000000000000000000000000000000000000000000000000000000000000000000000000000000000
0000000000000000000000000000000000000000000000000000000000000000000000000000000000000000000000000000000000000000000000000000000000000000000000000000000000000000
0000000000000000000000000000000000000000000000000000000000000000000000000000000000000000000000000000000000000000000000000000000000000000000000000000000000000000
0000000000000000000000000000000000000000000000000000000000000000000000000000000000000000000000000000000000000000000000000000000000000000000000000000000000000000
0000000000000000000000000000000000000000000000000000000000000000000000000000000000000000000000000000000022222000000000000000000000000000000000000000000000000000
0000000000000000000000000000000000000000000000000000000000000000000000000000000000000000000000000000000000000000000000000000000000000000000000000000000000000000
0000000000000000000000000000000000000000000000000000000000000000000000000000000000000000000022222000000000000000000000000000000000000000000000000000000000000000
0000000000000000000000000000000000000000000000000000000000000000000000000000000000022220000000000000000000000000000000000000000000000000000000000000000000000000
0000000000000000000000000000000000000000000000000000000000000000000000000000000000000000000000000000000000000000000000000000000000000000000000000000000000000000
0000000000000000000000000000000000000000000000000000000000000000000000000000222200222200022200022222000000000000000000000000000000000000000000000000000000000000
0000000000000000000000000000000000000000000000000000000000000000000000004000000000000000000000000000000000000000000000000000000000000000000000000000000000000000
0000000000000000000000000000000000000000000000000000000000000000000000005000000000000000000000000000000000000000000000000000000000000000000000000000000000000000
0000000000000000000000000000000000000000000000000000000000000000000222222000000000000000000000000000000000000000000000000000000000000000000000000000000000000000
0000000000000000000000000000000000000000000000000000000000000000000000000000000000000000000000000000000000000000000000000000000000000000000000000000000000000000
0000000000000000000000000000000000000000000000000000000000022222222000000000000000000000000000000000000000000000000000000000000000000000000000000000000000000000
0000000000000000000000000000000000000000000000000000000000000000000000000000000000000000000000000000000000000000000000000000000000000000000000000000000000000000
0000000000000000000000000000000000000000000000000000000000000000000000000000000000000400000000000000000000000002222pppppp222200000000000000000000000000000000000
000000000000000000000222222222202222220000000000000000000000000000000000000000000000050000000000000000000002222222ppppppp222222200000000000000000000000000000000
000000000000000000000000000000000000000000000000000000000000000000000000000000000222220000000000000000000022222222222222222222222222222p000000000000000000000000
0000000000000000000000000000000000000000000000000000000000002200000000000000000000000000000000000000000000000000000000000000000000000022222222200000000000000000
0000000000000000000000000000000000000000000000000000000000000000000000p00000000000000000000000000000000000000000000000000000000000000000000000000000000000000000
0000000000000000000000000000000000000000000000000000022220000000000222222000000000000000000000000000000000000000000000000000000000000000000000000000000000000000
0000000000000000000000000000000000000000000000000000000000000000000000000000000000000000000000000000222222222000000000000000000000000000000000000000000000000000
0000000000000000000000000000000000000000000000000220000000000000000000002220000000000000000000000000000000000000000000000000000000000000000000000000000000000000
0000000000000000000000000000000000000000000000000000000000000000000000000000000000000000000004000000000000000000000000004000000000000000000000000000000000000000
000000000000000000000000000000000000000000000000000000000000000000000000000000000000000pp00005pp0000000000000000000000005000000000000000000000000000000000000000
000000000000000000000000000000000000000222222222000p0000p000000000000000000000400000222222222222222222222pp22222000000002000000000000000000000000000000000000000
000000000000000000000000p000022222222220000000002222222220000000000000000000005000000000000000000000000022220000000000000000000000000000000000000000000000000000
0000000000000000000402222222220000000000000000000000000000000000000000002222222200000000000000000000000000000000000000000000000000000000000000000000000000000000
0000000000000000000500000000000000000000000000000000000000000000000000002222222200000000000000000000000000000000000000000000000000000002222000000000000000000000
0000000000222222222200000000000000000000000000000000000000000000000000000000000000000000000000000000000000000000000000000000000002222000000000000000000000000000
0000000000000000000000000000004000000000000000000000000000000000000000000000000000000000000000000000000000000000000000000000000000000000000400022222000000000000
000000000000000000000000000000500000000000000000000000pp0000000000ppppp000000000000000000000000p0000000000000000000000000000000000000000000500000000000000000000
3333333333333333333333333113333331133333333333333133333333331111133333333333313333333333311333333331313131111113333333333333133333333333333333333333113333313339
3333333333333333333333333113333331133333333333333133333333331111133333333333313333333333311333333331313131111113333333333333133333333333333333333333113333313330